BEDDING	B EH D IH NG
BOTTLE	B AA T AH L
CLOSE	K L OW S
CLOSE(2)	K L OW Z
DONE	D AH N
DRAWER	D R AO R
FETCH	F EH CH
GARMENT	G AA R M AH N T
GRASP	G R AE S P
GREEN	G R IY N
INCORRECT	IH N K ER EH K T
MAKE	M EY K
MEDICINE	M EH D AH S AH N
OBSTACLE	AA B S T AH K AH L
OPEN	OW P AH N
PAUSE	P AO Z
PURPLE	P ER P AH L
RED	R EH D
RELEASE	R IY L IY S
START	S T AA R T
STOP	S T AA P
TASK	T AE S K
WRAP	R AE P
YELLOW	Y EH L OW
